Date,is_52w_high,is_52w_low,hh-hl,trin,trin_13ma
2023-01-04,71,86,-15,0.5328896789633851,
2023-01-05,32,107,-75,0.6749914537225059,
2023-01-06,23,104,-81,1.5632877727659502,
2023-01-10,53,40,13,1.7948238608485962,
2023-01-11,53,25,28,1.1453993394790436,
2023-01-12,75,35,40,0.5617700403613076,
2023-01-13,115,65,50,0.4781904960401354,
2023-01-16,55,110,-55,1.5144308824640147,
2023-01-17,35,73,-38,1.0014950423658706,
2023-01-18,61,38,23,1.385385411326527,
2023-01-19,59,22,37,1.9606260628835803,
2023-01-20,75,36,39,0.6564833820490552,
2023-01-23,130,12,118,1.3123657661423602,1.0909821961797952
2023-01-24,152,3,149,0.9731699983169138,1.0741518821993836
2023-01-25,133,4,129,0.6954611482528845,1.0200532059213123
2023-01-26,129,5,124,0.8360249004056378,0.9937634479905018
2023-01-27,137,8,129,0.8848852433038669,0.978209418749554
2023-01-30,172,16,156,1.221275413800053,1.0129331323281967
2023-01-31,178,13,165,1.0731618149860542,1.021537229850748
2023-02-01,212,12,200,1.334815065718721,1.0662912064033157
2023-02-02,106,19,87,1.3102574345777467,1.1011435247139487
2023-02-03,77,25,52,0.7026463737040309,1.0442153602839606
2023-02-06,92,22,70,0.9734530362389605,1.0341064568489606
2023-02-07,103,18,85,0.7254049114022343,0.9900062360708569
2023-02-08,125,21,104,0.8235612181463758,0.9662283763673597
2023-02-09,140,26,114,1.3540079914701917,1.0216254642391929
2023-02-10,182,32,150,0.7477440715378594,0.9824995509961453
2023-02-13,138,50,88,0.42899296305498047,0.9034271812902647
2023-02-14,173,37,136,1.1290379737495833,0.9356572944987389
2023-02-15,197,60,137,0.4294206409127675,0.8633377725578859
2023-02-16,195,31,164,1.064307952270434,0.892047798231107
2023-02-17,157,44,113,0.7244330459048083,0.8681028336130645
2023-02-20,244,30,214,1.0469556693776987,0.8936532387222981
2023-02-21,303,24,279,0.9645383161610426,0.9037796783564045
2023-02-22,157,48,109,1.0570696214838498,0.9256782416603253
2023-02-24,249,46,203,1.4817783022855622,1.0051211074639306
2023-02-27,338,46,292,1.1629703987687872,1.0276710062217673
2023-02-28,311,18,293,1.5243538066095133,1.0986256919914454
2023-03-01,242,32,210,1.1933574790437795,1.1121588044274933
2023-03-02,317,34,283,1.3351755468086668,1.1440183390533754
2023-03-03,330,25,305,0.6702484137290151,1.0763369211498954
2023-03-06,410,33,377,0.9958854288929044,1.0648438508274682
2023-03-07,423,28,395,0.8188672028615471,1.0297043296894797
2023-03-08,455,27,428,1.2374900855445738,1.0593880090973502
2023-03-09,621,26,595,0.562697686766903,0.9884322487644293
2023-03-10,170,21,149,1.2379756432253892,1.024081305115995
2023-03-13,42,57,-15,0.5897629484454001,0.9620358255916244
2023-03-14,31,113,-82,0.8754163168732235,0.9496616100604243
2023-03-15,56,53,3,0.9378150282738822,0.9479692412337755
2023-03-16,33,203,-170,0.5473011566383963,0.8907309434344356
2023-03-17,71,56,15,1.7229974483066663,1.009626158416183
2023-03-20,60,126,-66,0.6190575460527897,0.9538306423642696
2023-03-22,75,43,32,0.9758236842983183,0.9569725054977052
2023-03-23,64,68,-4,1.779446960163612,1.0744688561642635
2023-03-24,88,48,40,1.5383178284952501,1.1407329950686902
2023-03-27,100,30,70,1.4400607839490418,1.1834941077658834
2023-03-28,68,49,19,0.39672011686687475,1.0710978233517394
2023-03-29,106,45,61,0.8971093802830307,1.046242331484781
2023-03-30,189,32,157,1.7246263007934841,1.1431543271003102
2023-03-31,243,19,224,1.0183784237177644,1.1253291980456608
2023-04-03,289,16,273,0.9666922095316554,1.1026667711150886
2023-04-04,207,17,190,0.5390029650100345,1.022143370242938
2023-04-05,59,33,26,0.6058982265664175,0.9626797782891494
2023-04-06,45,56,-11,1.033864897837972,0.9728490810818384
2023-04-07,56,58,-2,1.025683184953573,0.980396810206372
2023-04-10,88,54,34,0.7554978355637493,0.9482683852574261
2023-04-11,107,35,72,0.8616574044798133,0.9358953880034815
2023-04-12,131,30,101,0.6545475308714949,0.8957028369846263
2023-04-13,129,43,86,1.473497712614811,0.9782449620746527
2023-04-14,183,35,148,1.4161912085507349,1.040808711571236
2023-04-17,169,40,129,0.714453493509964,0.9941865375624828
2023-04-18,223,38,185,0.7337554955609055,0.956982102990829
2023-04-19,134,40,94,0.756146303597735,0.9282912745061014
2023-04-20,192,39,153,1.324138042483231,0.9848408127885484
2023-04-21,203,56,147,1.1549154671884891,1.00913719198854
2023-04-24,243,43,200,1.2250706998375405,1.0399848359669686
2023-04-25,369,53,316,1.3568209221736354,1.0852471339964924
2023-04-26,112,71,41,0.41630013418689565,0.9896832768808358
2023-04-27,118,71,47,0.7629851612041302,0.9572978317841636
2023-04-28,341,50,291,1.5694618828334355,1.0447498390769168
2023-05-01,520,44,476,1.1309890098995192,1.0570697206230029
2023-05-02,352,55,297,0.9641831846515372,1.043800215484222
2023-05-08,373,24,349,1.581023891343014,1.120546454892621
2023-05-09,511,27,484,0.6758698428854548,1.057021224605883
2023-05-10,373,33,340,0.8293659012925684,1.0244990355611239
2023-05-11,201,31,170,0.9826191372309987,1.0185161929425346
2023-05-12,305,63,242,1.2305631679912419,1.0488086179494929
2023-05-15,442,92,350,0.6339361147575396,0.9895411174934996
2023-05-16,422,110,312,1.176894764824369,1.0163059242550525
2023-05-17,365,95,270,0.5959977433812543,0.9562618984159386
2023-05-18,362,82,280,0.6572633710636533,0.9135478230798979
2023-05-19,315,71,244,1.260604100885803,0.9631272913378843
2023-05-22,292,67,225,1.102724967553513,0.9830698165115457
2023-05-23,367,62,305,0.5334440488298706,0.9188375639855921
2023-05-24,81,42,39,0.8818468949000875,0.913553182687663
2023-05-25,119,57,62,1.3991121647676454,0.9829187515562319
2023-05-26,155,85,70,0.7821544745634574,0.9542381405572641
2023-05-29,265,85,180,0.8962083626748938,0.945948172288354
2023-05-30,111,103,8,0.8793409750823322,0.9364328584017796
2023-05-31,77,122,-45,1.1091614789959052,0.9611083756295119
2023-06-01,64,117,-53,0.5744886514805426,0.9058769864653735
2023-06-02,149,72,77,0.9708232881277051,0.9151550295599924
2023-06-05,368,38,330,1.1163226029455684,0.9438932543293604
2023-06-06,327,41,286,0.6783109727758966,0.9059529283931514
2023-06-07,401,35,366,1.6014722837527884,1.005312836301671
2023-06-08,119,37,82,0.5969893591560401,0.9469809109951524
2023-06-09,174,30,144,0.794065133502625,0.9251357999247913
2023-06-12,356,24,332,2.0546514833851752,1.0864951832762748
2023-06-13,519,33,486,0.8545375858702212,1.0533583836468385
2023-06-14,546,45,501,0.788717239841174,1.015552505960315
2023-06-15,466,49,417,0.9451398573305592,1.0054935561560643
2023-06-16,359,34,325,1.7058036656841444,1.1055378575172186
2023-06-19,482,39,443,1.117394174239074,1.1072316170489123
2023-06-20,245,22,223,1.3038713699430935,1.1353230103195096
2023-06-21,368,11,357,0.7511037854557011,1.0804345496246799
2023-06-22,378,18,360,0.42352788776758027,0.9865907407879515
2023-06-23,295,26,269,0.9372936567473987,0.9795483002107297
2023-06-26,151,37,114,0.8691148844893007,0.9637720979648113
2023-06-27,118,51,67,0.7647727661033191,0.9353436219845982
2023-06-28,291,23,268,0.8406827832610152,0.9218206450240863
2023-06-29,420,20,400,1.498885903209275,1.0042585390505419
2023-06-30,251,20,231,1.4804211781924184,1.0722817732136671
2023-07-03,543,31,512,0.6610803066156421,1.0135387065568064
2023-07-04,389,19,370,0.8807814774943594,0.9945733881193141
2023-07-05,258,28,230,0.5315735124347094,0.9284305487357992
2023-07-06,156,39,117,0.7337667955450355,0.9006214411371188
2023-07-07,96,49,47,1.2548888373789107,0.9512310691716606
2023-07-10,144,35,109,0.8485201180142816,0.936558076149178
2023-07-11,119,29,90,1.4003074952348282,1.0028079931614138
2023-07-12,96,48,48,0.45380084084874395,0.9243783999738895
2023-07-13,75,52,23,1.0432715178485512,0.9413631310988413
2023-07-14,88,48,40,1.084779403704871,0.9618511700425598
2023-07-18,119,45,74,1.2733641717750712,1.0063530274329187
2023-07-19,191,30,161,0.966252927064155,1.0006244416659524
2023-07-20,213,29,184,0.7907823810073447,0.9706470044290085
2023-07-21,134,38,96,0.5700184856250511,0.9134143588855861
2023-07-24,260,24,236,0.9310981894053401,0.9159406203884082
2023-07-25,301,34,267,0.7667654569327458,0.894629882751885
2023-07-26,203,30,173,1.637233892611318,1.0007161698746612
2023-07-27,196,27,169,0.8489196134986805,0.9790309475352353
2023-07-28,183,64,119,0.8344976483063511,0.9583833333596805
2023-07-31,513,36,477,0.9369207787990838,0.9553172541367382
2023-08-01,428,44,384,1.0750489472150297,0.9724217817193513
2023-08-02,248,40,208,0.790554211257736,0.9464407002248348
2023-08-03,53,105,-52,0.5845302971052625,0.894739214064896
2023-08-04,97,114,-17,1.1015638115561628,0.9242855851350771
2023-08-07,165,76,89,1.2708545244004956,0.9737954336015655
2023-08-08,226,38,188,0.7274360544161378,0.9386012365750759
2023-08-09,171,60,111,0.6832039036621593,0.9021159033018021
2023-08-10,250,81,169,0.7793423194180324,0.884576819889835
2023-08-14,317,102,215,0.8789494752715297,0.8837729135157915
2023-08-15,184,144,40,0.8473981721605901,0.8785765218936199
2023-08-16,138,168,-30,0.9539082552167177,0.889338198082634
2023-08-17,71,248,-177,0.5635212306187295,0.8427929170163619
2023-08-18,41,175,-134,0.6633523491311146,0.8171585501756123
2023-08-21,74,101,-27,1.4338517676303981,0.9052575812405818
2023-08-22,102,65,37,0.589326613360158,0.8601245858290927
2023-08-23,143,54,89,1.1870999373686757,0.9068353503347475
2023-08-24,199,34,165,0.9952169228562676,0.9194612892663934
2023-08-25,114,34,80,1.285114037970886,0.9716973962241781
2023-08-28,266,20,246,1.171830970306182,1.0002879068073214
2023-08-29,318,11,307,1.0541980866906768,1.0079893610763722
2023-08-30,319,14,305,0.641432201116661,0.9556240525106992
2023-08-31,381,22,359,0.8334911117601144,0.93817648954633
2023-09-01,460,19,441,0.6252220931164577,0.8934687186277769
2023-09-04,641,15,626,0.6887801887103342,0.8642275000681423
2023-09-05,570,17,553,1.2638259167548949,0.9213129881662498
2023-09-06,600,23,577,0.515074814803405,0.8632789634001292
2023-09-07,492,23,469,0.7540220822966035,0.8476708375281969
2023-09-08,221,33,188,1.2123598939140474,0.8997692741547471
2023-09-11,291,45,246,0.7118557528725104,0.8729244854001419
2023-09-12,340,34,306,1.2305988666127192,0.9240208255733673
2023-09-13,343,32,311,0.3705237637261416,0.8449498167380495
2023-09-14,391,38,353,0.5320076410939708,0.8002437916460383
2023-09-15,620,56,564,0.6493082648724904,0.7786815735355315
2023-09-19,456,52,404,0.6759234237583004,0.7640018378530699
2023-09-20,426,65,361,1.4530609021747434,0.8624388470418805
2023-09-21,169,103,66,0.7298565740904791,0.8434985223345374
2023-09-22,117,118,-1,1.185970324604809,0.8924230655160048
2023-09-25,193,25,168,1.4870656279174856,0.9773720030019307
2023-09-26,173,34,139,0.868049611361279,0.9617545184818377
2023-09-27,152,45,107,1.2996587834913678,1.010026556340342
2023-09-28,263,44,219,0.9716409578385892,1.0045428994115202
2023-09-29,143,33,110,1.8897941811909038,1.1310073682371464
2023-10-02,136,63,73,0.7135400873653672,1.0713691852554637
2023-10-03,30,190,-160,0.5708334465251907,0.9998640797225675
2023-10-04,15,316,-301,0.4801522958698921,0.9256195391721853
2023-10-05,28,113,-85,1.1650927818155337,0.9598300024069494
2023-10-06,39,79,-40,1.5337756526675987,1.0418222381584707
2023-10-10,85,36,49,0.679374001278303,0.9900439186041612
2023-10-11,69,48,21,0.8273260629907604,0.9667985106593897
2023-10-12,92,76,16,0.7936938705668516,0.9420692763604557
2023-10-13,70,141,-71,0.831943363124566,0.9263370030410429
2023-10-16,27,278,-251,0.6752913654551345,0.8904733405287704
2023-10-17,53,121,-68,0.9724819383119758,0.9021888544977997
2023-10-18,63,144,-81,1.7194897122315713,1.0189461198883385
2023-10-19,47,165,-118,0.6878268399996268,0.9716433656185226
2023-10-20,43,251,-208,0.9684740005938242,0.9711905991864228
2023-10-23,38,282,-244,0.8010250770680165,0.9468812388837934
2023-10-24,20,406,-386,1.3747641714851992,1.0080073721125657
2023-10-25,54,43,11,0.661739275724984,0.9585405012000542
2023-10-26,40,106,-66,0.8805251787856352,0.9473954551408516
2023-10-27,75,87,-12,1.1410357328135308,0.9750583519512344
2023-10-30,76,167,-91,1.6003890303346562,1.0643913060060088
2023-10-31,103,190,-87,1.1771148554803637,1.080494670216631
2023-11-01,210,83,127,0.6132262256401554,1.0137420352771345
2023-11-02,209,56,153,1.2283498363383203,1.0444002925715896
2023-11-06,186,27,159,1.655787162414861,1.1317412739777715
2023-11-07,137,31,106,1.7135779751071814,1.2148608027105445
2023-11-08,72,51,21,1.0666711503124506,1.1936908523679597
2023-11-09,91,47,44,0.5716324129262011,1.1048253610191372
2023-11-10,105,80,25,0.778583206060957,1.0582193388822543
2023-11-13,172,105,67,0.6636010689611342,1.0018453003220944
2023-11-14,140,128,12,0.6289881641829193,0.9485799951593552
2023-11-15,164,137,27,1.4823142368893696,1.0248277439779288
2023-11-16,117,126,-9,0.6761306654027676,0.9750138756100487
2023-11-17,127,129,-2,0.9727295180218094,0.9746875388117289
2023-11-20,194,67,127,0.8953148086006917,0.9633485773530093
2023-11-21,90,40,50,1.2811412051280828,1.00874752417802
2023-11-22,139,30,109,1.2345436136941403,1.0410041083946087
2023-11-24,200,33,167,1.1263946987496694,1.0532027641596173
2023-11-27,183,38,145,0.7988175961179472,1.0168620258679502
2023-11-28,143,45,98,1.1546570387716273,1.0365470277113327
2023-11-29,129,47,82,1.2493338095594573,1.066945139403922
2023-11-30,137,54,83,1.0272778625687993,1.0612783855703332
2023-12-01,181,74,107,0.45456393902203496,0.9746048932062906
2023-12-04,148,86,62,1.1847310725028894,1.0046229188200906
2023-12-05,118,82,36,0.5145777090764233,0.934616460285281
2023-12-06,174,84,90,1.1714121761725629,0.9684444196977499
2023-12-07,111,124,-13,0.4049038873294362,0.8879386293594194
2023-12-08,77,211,-134,0.5322810172956829,0.8371303990645999
2023-12-11,120,141,-21,0.8786100389998744,0.8430560619124963
2023-12-12,149,189,-40,1.5199817796773043,0.9397597358788975
2023-12-13,119,199,-80,1.4915319634734998,1.0185843398209837
2023-12-14,119,213,-94,1.3189869595882993,1.061498999787743
2023-12-15,70,154,-84,1.6504616332340527,1.1456365188515016
2023-12-18,54,188,-134,0.8390076545036331,1.1018323953732347
2023-12-19,97,136,-39,1.5225724810239953,1.161938121894772
2023-12-20,161,89,72,0.7464129932834516,1.102577389236012
2023-12-21,50,161,-111,0.42105821897860013,1.0052175077706675
2023-12-22,101,167,-66,0.5591943439229593,0.9414999129352807
2023-12-25,146,242,-96,1.5562625009389348,1.0293231397929457
2023-12-26,86,225,-139,1.40196161311454,1.0825572074103165
2023-12-27,130,145,-15,0.61710807185697,1.0160644737598385
2023-12-28,177,43,134,1.2979628010856035,1.056335663377805
2023-12-29,166,12,154,0.7971033341918661,1.0193024734940994
2024-01-04,243,14,229,0.6300098672020451,0.963689244023806
2024-01-05,304,15,289,0.5203230045575817,0.9003512098143455
2024-01-09,395,23,372,1.57619067884363,0.9968997053899576
2024-01-10,379,20,359,0.934140187350141,0.9879340599556982
2024-01-11,461,23,438,0.519942309318268,0.9210780955789225
2024-01-12,353,26,327,0.8905818405352972,0.9167214877155475
2024-01-15,202,10,192,0.4331243940789931,0.8476361886246112
2024-01-16,443,42,401,0.6668923989095545,0.821815647236746
2024-01-17,368,52,316,0.4293169255830568,0.7657444012862191
2024-01-18,155,70,85,1.2126974296447304,0.8295948339088636
2024-01-19,202,37,165,1.4329147557569433,0.915783394172875
2024-01-22,390,35,355,0.9989999246064515,0.9276714699491002
2024-01-23,400,27,373,0.9593096968614185,0.93219121665086
2024-01-24,165,12,153,0.911590590059066,0.9292482699948894
2024-01-25,243,20,223,1.4996211020841097,1.0107301031504925
2024-01-26,199,13,186,1.6224438401299328,1.0981177798618411
2024-01-29,277,13,264,0.9280991575147032,1.0738294052408215
2024-01-30,281,25,256,0.8147370767639405,1.03681621545841
2024-01-31,287,34,253,0.9294935587072032,1.0214844073510947
2024-02-01,284,55,229,0.6533584545503955,0.9688949855224234
2024-02-02,285,35,250,1.0753754700759472,0.984106483315784
2024-02-05,350,38,312,1.021794832803039,0.9894905332425348
2024-02-06,228,40,188,0.7912989756278858,0.9611774535832992
2024-02-07,229,54,175,0.6720844860763655,0.9198784582251659
2024-02-08,228,97,131,0.9913141442650873,0.930083556230869
2024-02-09,240,90,150,0.8683913862553808,0.9212703890915136
2024-02-13,348,95,253,0.5755294384399688,0.8718788247127215
2024-02-14,202,153,49,0.5434309593041994,0.8249577010829326
2024-02-15,257,262,-5,0.5568727657823411,0.7866598531828483
2024-02-16,316,163,153,1.1880169529781215,0.8439965817250301
2024-02-19,280,49,231,1.121656188386168,0.8836622398194784
2024-02-20,304,27,277,1.0854388047524615,0.9124874633813332
2024-02-21,140,32,108,0.7159243907603057,0.8844070244354723
2024-02-22,277,78,199,0.792838885179474,0.8713258616846155
2024-02-26,433,45,388,0.7911546856144246,0.8598728365317311
2024-02-27,328,39,289,0.9893764319901399,0.8783733501686467
2024-02-28,331,20,311,0.8694676178921323,0.8771011027005733
2024-02-29,222,37,185,0.7140544426460439,0.8538087226927834
2024-03-01,327,50,277,0.6033321139587414,0.8180263500164917
2024-03-04,367,62,305,0.7533466584590067,0.8087863940797082
2024-03-05,239,85,154,0.9620410448147185,0.8306799156132811
2024-03-06,314,42,272,0.751047226321318,0.8193038171430007
2024-03-07,388,54,334,0.5757251666440476,0.7845068670717218
2024-03-08,303,65,238,0.8564162387598386,0.7947796344557385
2024-03-11,100,64,36,0.8945013005876594,0.8090255867602987
2024-03-12,70,70,0,3.17623206076612,1.147197940189702
2024-03-13,124,47,77,0.6836809873191979,1.080981232636773
2024-03-14,123,25,98,1.0808672933863852,1.0809649556010033
2024-03-15,164,36,128,0.7677414455690419,1.0362187398821516
2024-03-18,252,19,233,1.0570929885499405,1.0392007754061214
2024-03-19,296,23,273,1.3106533536041083,1.077979715148691
2024-03-21,612,28,584,1.1119673115047162,1.0828350860566947
2024-03-22,527,27,500,0.7300855951120806,1.0324423016360356
2024-03-25,379,17,362,1.402976180075614,1.0853757128416897
2024-03-26,216,23,193,0.7622029514274522,1.0392081754967986
2024-03-27,376,14,362,1.2921002902244156,1.0753356204578868
2024-03-28,337,20,317,1.0314438283391905,1.0690653644409303
2024-03-29,335,13,322,1.3267455020253136,1.1058768126672707
2024-04-01,363,22,341,1.240901378408465,1.1251660363445843
2024-04-02,81,58,23,0.27368655626237315,1.0035261106185542
2024-04-03,94,80,14,1.1593007521414829,1.0257796308361156
2024-04-04,152,45,107,0.7456362625959471,0.9857591496589487
2024-04-05,65,86,-21,0.9611897028012081,0.9822492286792716
2024-04-08,152,30,122,0.8940357996645238,0.9696473102485934
2024-04-09,183,17,166,0.779290688777403,0.9424535071812805
2024-04-10,236,15,221,1.2272255564984802,0.9831352285123092
2024-04-11,197,42,155,0.7385646439375796,0.9481965735730621
2024-04-12,255,39,216,1.1808470537599642,0.9814323564569053
2024-04-15,202,87,115,0.592028017624681,0.925803165195159
2024-04-16,75,135,-60,0.7176438855059599,0.8960661252395592
2024-04-17,37,157,-120,0.9834119952338228,0.9085441066673112
2024-04-18,42,82,-40,2.1152088576862673,1.080924785384305
2024-04-19,39,213,-174,0.5843780321560171,1.0099895349231212
2024-04-22,64,57,7,1.768169889191933,1.11830101410438
2024-04-23,76,32,44,1.7815649308465715,1.2130530022104076
2024-04-24,80,24,56,1.6447146492069344,1.27471895178134
2024-04-25,59,38,21,1.2962515039193887,1.2777950306582042
2024-04-26,70,80,-10,0.8722923966620505,1.219866082944468
2024-04-30,171,49,122,1.3357844571792108,1.2364258506922887
2024-05-01,98,50,48,1.1386450050585206,1.2224571584588935
2024-05-02,101,44,57,1.0528137363523857,1.1982223838722494
2024-05-07,154,32,122,1.7421134071927253,1.2759211014894605
2024-05-08,113,27,86,1.5367899237837872,1.3131880761029358
2024-05-09,148,40,108,1.145673263387093,1.2892573885721013
2024-05-10,229,42,187,1.100613052834353,1.2623081977524229
2024-05-13,188,60,128,1.4157837483267388,1.2842332764058966
2024-05-14,158,41,117,1.1486185933849482,1.264859750260047
2024-05-15,178,75,103,0.8491408602804701,1.2054713374058217
2024-05-16,127,142,-15,1.3066759432468742,1.2199291382402577
2024-05-17,130,95,35,1.0941945870777225,1.2019670595027527
2024-05-20,214,58,156,0.7655691243935964,1.139624497344302
2024-05-21,210,69,141,0.7476526862255596,1.083628524327339
2024-05-22,123,111,12,0.750276066996331,1.0360067447086236
2024-05-23,92,157,-65,0.8167624905001897,1.0046861369645617
2024-05-24,77,178,-101,1.2029186672285486,1.0330050698594169
2024-05-27,111,132,-21,0.6532921056343259,0.978760360684404
2024-05-28,155,60,95,0.72870807633748,0.9430386057777006
2024-05-29,144,184,-40,0.6914825078110334,0.9071020203538911
2024-05-30,56,265,-209,1.0209966166312177,0.9233726769649379
2024-05-31,144,58,86,1.1254582369870927,0.9522420426823887
2024-06-03,254,31,223,0.7994651726425615,0.930416775533842
2024-06-04,145,24,121,1.6516558631710694,1.0334509309105888
2024-06-05,59,33,26,1.2693975125123464,1.0671575854251256
2024-06-06,78,56,22,1.1329636511542667,1.0765584519578602
2024-06-07,80,67,13,1.6222937711465606,1.1545206404133888
2024-06-10,140,47,93,1.016342327844448,1.1347808814749687
2024-06-11,168,26,142,0.9639703116057659,1.110379371493654
2024-06-12,121,50,71,1.9394602125273817,1.2288194916413295
2024-06-13,115,79,36,0.8937376646896774,1.180950659219665
2024-06-14,170,97,73,2.6691714165862295,1.3935536245577458
2024-06-17,124,94,30,1.1743729021254063,1.3622420927816974
2024-06-18,189,45,144,0.9683926622185168,1.3059778884155286
2024-06-19,205,51,154,0.8974349244413312,1.2476146078477863
2024-06-20,167,53,114,1.071091576013074,1.2223970318713988
2024-06-21,150,25,125,0.9588578809562313,1.1847485817406607
2024-06-24,141,17,124,0.8697693303126658,1.139751545822376
2024-06-25,203,13,190,0.6393795132077846,1.0682698268774344
2024-06-26,236,18,218,1.1018252243153384,1.0730634550828493
2024-06-27,246,17,229,1.2041975471218676,1.091796896802709
2024-06-28,260,27,233,0.5873106164621247,1.0197274281826254
2024-07-01,245,35,210,2.260623227717214,1.1969982566875665
2024-07-02,254,39,215,0.8041439867328186,1.1408762181226024
2024-07-03,243,36,207,0.7140488565716941,1.0799008807581871
2024-07-04,315,44,271,0.9837320233454652,1.0661624725563699
2024-07-05,217,54,163,0.7218807237970899,1.0169793655907584
2024-07-08,153,54,99,0.9755435584784977,1.0110599645747211
2024-07-09,208,60,148,1.0660890943467405,1.0189212688278668
2024-07-10,191,58,133,0.5167999674817036,0.9471896543498435
2024-07-11,271,50,221,1.363925409413609,1.0067233336446673
2024-07-12,147,25,122,2.2989798333169165,1.1913314050264172
2024-07-16,215,23,192,1.1239957345909057,1.18171202353563
2024-07-17,238,20,218,0.6905878782608947,1.111551431353525
2024-07-18,145,17,128,0.7361869843618191,1.0579279389261387
2024-07-19,75,28,47,1.0952898968465454,1.0632653614861969
2024-07-22,74,46,28,0.5992137619537212,0.9969722758387004
2024-07-23,97,32,65,0.6393618011661882,0.9458850651711987
2024-07-24,66,61,5,1.0786308960478608,0.9648487552964362
2024-07-25,27,113,-86,0.6258485029501095,0.9164201478183895
2024-07-26,23,59,-36,1.4534143109767443,0.9931335996981545
2024-07-29,65,41,24,0.9720174871589841,0.9901170121925588
2024-07-30,65,77,-12,0.5685045082209984,0.9298866544823359
